cha cha cha's: cha cha cha, 
lulu: lola, 
cassis: pastis, 
tommy's: jimmy's, 
philippe the original: philippe's the original, 
second street grill: second street grille, 
first: feast, 
palm: palio, 
canter's: langer's, 
drago: prego, spago, 
caffe roma: cafe roma, 
r-23: 2223, 
postrio: posto, 
west: feast, 
c3: ct, 
sofi: soto, 
patina: patria, 
posto: postrio, soto, 
march: match, marichu, 
sea grill: mesa grill, mesa grill, 
palio: pamir, 
aqua: aja, 
joe's: bone's, joss, rae's, 
lola: layla, bolo, 
zarela: zarzuela, 
katsu: eats, 
cafe blanc: cafe bianco, 
bruno: bruno's, 
felix: fenix, 
patria: patina, 
cite: ct, dive, 
match: march, 
march: marichu, 
nava: yama, diva, aja, cava, 
steak house  the: steakhouse  the, 
drai's: rae's, 
yama: aja, cava, 
girafe: jiraffe, 
vida: diva, 
johnny rockets (la): johnny rockets (at), 
aqua: aja, 
tapika: taiko, 
zoe: home, 
diva: cava, dive, 
bolo: soto, 
aja: cava, 
cava: carta, 
